##########
#o       #
####  ####
#        #
#  #  #  #
# ########
#        #
##### ####
#       x#
##########